XXXXXXXXXX
XOX SX   X
X X      X
X   XXXX X
X XXXO X X
X X S  X X
X XXXX   X
X   XOX XX
XXX     XX
XXXXXXXXXX