XXXXXXXXXX
X X  X   X
X X      X
X   XXXX X
X XXX  X X
X X    X X
X XXXX   X
X   X X XX
XXX     XX
XXXXXXXXXX